1111111111
1000111111
1110001111
1111100011
1111111111